31111111132
21122131202
33023022112
20310213122
31011120202
21230230112
30223031302
03122121212
22203110322
22110311002
11111101110


